R 1920 1080
NO ./textures/cat/text1.xpm
SO ./textures/cat/text2.xpm
WE ./textures/cat/text3.xpm
EA ./textures/cat/text4.xpm
S ./textures/cat/nyan.xpm
C 204,255,255
F 204,255,204

111111111111111111111111 1111
10000000001100000000000111021
10110000011100000002000010001
10010020000000000000000010001
10110000011100000000000010001
10000000001100000111011110001
11110111111111011100000010001
11110111111111011101010010001
11000000110101011100000010021
10000002000000001100000010001
1000N000000000001101010010001
11020000110101000000000000001
11111111111111111111111111111